{
	"tiles": [
		[0, 0, 0, 0, 0, 0, 8, 8, 8, 8, 8, 8, 8, 0, 0, 0, 0, 0],
		[0, 0, 0, 0, 0, 0, 8, 0, 0, 0, 0, 0, 8, 0, 1, 1, 0, 0],
		[2, 2, 0, 2, 2, 2, 8, 0, 0, 0, 0, 0, 8, 0, 0, 1, 0, 0],
		[2, 2, 4, 2, 2, 2, 8, 0, 0, 0, 0, 0, 8, 3, 3, 5, 3, 3],
		[0, 0, 1, 0, 0, 0, 8, 8, 8, 0, 8, 8, 8, 3, 3, 5, 3, 3],
		[0, 0, 1, 0, 0, 0, 0, 0, 8, 0, 8, 0, 0, 0, 0, 1, 0, 0],
		[0, 0, 1, 0, 0, 0, 0, 0, 0, 1, 0, 0, 0, 0, 0, 1, 0, 0],
		[0, 0, 1, 1, 1, 1, 1, 1, 1, 1, 1, 1, 1, 1, 1, 1, 0, 0],
		[0, 0, 0, 0, 0, 0, 0, 0, 0, 0, 1, 0, 0, 0, 0, 0, 0, 0],
		[0, 7, 7, 7, 7, 7, 7, 7, 0, 0, 1, 0, 0, 0, 0, 0, 0, 0],
		[0, 7, 7, 7, 7, 7, 7, 7, 0, 0, 1, 0, 0, 0, 0, 0, 0, 0],
		[0, 7, 7, 7, 6, 6, 6, 6, 1, 1, 1, 0, 0, 0, 0, 0, 0, 0],
		[0, 7, 7, 7, 7, 7, 7, 7, 0, 0, 0, 0, 0, 0, 0, 0, 0, 0],
		[0, 7, 7, 7, 7, 7, 7, 7, 0, 0, 0, 0, 0, 0, 0, 0, 0, 0],
		[0, 0, 0, 0, 0, 0, 0, 0, 0, 0, 0, 0, 0, 0, 0, 0, 0, 0],
		[0, 0, 0, 0, 0, 0, 0, 0, 0, 0, 0, 0, 0, 0, 0, 0, 0, 0],
		[0, 0, 0, 0, 0, 0, 0, 0, 0, 0, 0, 0, 0, 0, 0, 0, 0, 0]
	],
	"items": [
		{
			"id": 1,
			"itemType": "gold",
			"col": 1,
			"row": 1
		},
		{
			"id": 2,
			"itemType": "chest_closed",
			"col": 2,
			"row": 1
		},
		{
			"id": 3,
			"itemType": "chest_open",
			"col": 3,
			"row": 1
		}
	],
	"npcs": [
		{
			"npcid": 7,
			"type": "friendly",
			"col": 8,
			"row": 1
		},
		{
			"npcid": 8,
			"type": "enemy",
			"col": 9,
			"row": 1
		},
		{
			"npcid": 11,
			"type": "enemy",
			"col": 10,
			"row": 1
		}
	]
}
